33333333
33333333
53333333
33334444
33334443
33444544
44554444
44544444
